"±±±±±±±f          F°°°°°                    °°°°° 1±   0       ^^^      "
"2     ±±±±±±±E         e°°°°  °°°×°°°  °°°°      ±  ^^ ^   ^^^^^a^ ^^^A×"
"°°°°° °       ±±±±±±         °°°   ×   °°°         ±                    ^×"
"G  ° °            g±±±±±                     ±±±±±    / c     CB     b^^±×"
"H°°°° °            h 2   ±±±±             ±±±±        /             ^^^±± ×"
"I                  i±±± ±    ±±±       ±±±           /             ^±±    ×"
"°°°°          ±±±±±± 1^ ^       ±±   ±±             /             ^±      ×"
"       ±±±±±±±   °  /            ± ±             dÛ              ±    °°°"
"×±±±±±±           ° / ^ ^                           \       /\   ^±   °°  ×"
"×                °                                   \     /\  ±   °    ×"
"×      ²         ° /  ^ ^                             \   /    \          ×"
"×      ²         °                 ÛD                  \ /      \   °°°°°°×"
"×      ²        °     ^ ^          ^                   ° ±      ±         ×"
"×²    ²²²       ° /                                    ° ±      ±    °    ×"
"                °     ^ ^          ^                  °  ± °  ° ±     °°  ×"
"       ²        °               Û     Û               ° ^± °  ° ±      °°°"
"       ²   ²²  °      ^ ^          ^                  ° ±  °  °  ±        ×"
"       ²   ²  ° /                                   °  ±  °  °  ±        ×"
"       ²   ²   °      ^      Û     ^     Û           ° ^± °    ° ±        ×"
"×²    ²²   ²   °                                   °°  ±  ° /\ °  ±       ×"
"×       ²  ²   °      ^   Û        ^        Û    °°   ^±  ° /\ °  ±       ×"
"×             °        Û                       Û    ^^±  °  /\  °  ±      ×"
"×             °       ^            ^             ^^^±±   ° /  \ °   ±±    ×"
"×             °                                  ±±±    °  /  \  °    ^±±×"
"×               ^^^^^^^            ^              0   °° ^^    ^^ °°    ±×"
