"A±±±±±±±±±±±±±±±a    ùùùùùùùùùùùùùùùùùùùùùùùùùùùùùùùùùùùùùùùùùùùùùùùùù°ùùùù"
"        ±   5       ùùùùùù°°°°°°°ùùùùùùùùùùùùù°°°°°°°°°°°ùùùùùùùùùùùù° °ùùù"
"  ±     ±          ùùù°°°°/     \°°°°ùùùùùù°°°/         \°°°°.........°...."
" ±±±   ²²²²²\      ùù°/\°           \°ùùùù°/    /°g      °  \°°°°°........."
"±± ±±²²²²   ²\ ^   ù°/ h° ^^^^×H°°°°°°°ùù°/    / °       °       \°...°...."
"0±±± ²²²²  0²\    ù°  i°  3 °×I°    2°ùù°    /  °       °  F     1°f° °..."
"  ±    ²²²²²²²²²   ù°\ j° ^^ °×J°   /°ùùù°\2 /   °       °  °°°°°°°°.° °..."
"       ²²²²²²²     ùù°\k°  ^ °×K  /°°ùù ùù°\     °       ° °      /°..°..."
"        ²  ²       ùùù°l°\   °×L °°ùùù   ùù°\    °               /°....... "
" ^      ²  ²  Û      ùù°°°°°°°°°°ùùùù    ùùù°°°\^°G           /°°°   ±±±   "
"      ÛÛÛÛÛÛÛÛ          /  6/   /            / °°°°\^^^^/°°°°°°      ±±±   "
"        3              /   /   /            /   /  °°°°°°                 "
"   ^                  /   /   /            /   /       /  ù²²²²²²²²²²²²²²²²"
"^          ²²  ÛÛ  ²²  ÛÛ  ²²  ÛÛ   ±            ±±±  /  ù ²²²²²²²²²²²²²²²²"
" ^   ^ ²  ²/\²Û/\Û²4  Û/\Û   ²Û/\Û  ±  ²^²²     ±±±    ù  ²²²²²²²²²²²²²²²²"
"       ²  ²\/²Û\/Û²\ ²Û\/Û² /²Û\/Û  ±  ² ²²²²²²²² ²²²²     ²²²²²²²²²²²²²²²²"
"       ² °°²²±±ÛÛ°°²²±±ÛÛ°° ²±±ÛÛ°° ±  ² ²²²²²²²² ²  ²    ù²²²²²²²²²²²²²²²²"
"   ^^^^²°4 °±5 ±° 6°±/\±°7  ±7 ±°/  ±^ ² ²²²²²²²² ²  ²   ù ²²²²²²²²²²²²²²²²"
"  ^    ²°\°±\ ±° /°±\/±°\ °±\ ±°  °±  ² ²²²²²²²² ²  ²²²²    8             "
"       ² °°       °  ±±  °°  ±    ° ±8/²²²²²²²²² ²²²²²²²    ±±±±±±±±±±±±  "
"       ²²²²²²²²²²²²²²²²²²²²²²²²²²²²²²²²² ²²²²²²²² ²²²²²²²    ±    ±±    ± "
"^                                                 ²²²        ± ±± ±±    ±  "
" ^     ×°°°        °°°   °°°        °°°  °°° °°°  ²²² °°°    ± ±± ±±    ±  "
"  ×  × ×°°°B  b c C°°°øøø°°°D  d e E°°°øø°°°ø°°°1     °°°    ± ±± ±±±±±±±  "
"^^^^^^^^°°°^^^^^^^^°°°^^^°°°^^^^^^^^°°°^^°°°^°°°^^^^^^°°°^^^^± ±± ±±±±±±±^"
