"                                  ²²²²ÛÛABCDÛÛ   ²                       "
"                               q  ²    ÛE0FÛ0    ²  ±  ±±±±±±±±±±±±±±±±±± "
"                               ±  ²×²² ÛG  IÛÛ\   ²  ±  ±°°°              "
"±±±±    ±                Q     °  ² ²  ÛJ 1KÛ1 \  ²  ±^  ×°°°°     °°°°°°°"
"        °               ±±     °  ² ² / LMNO\  \ ²  ×±    ×××°°°°°     °°°"
"        °               °      °  ² ²         \   ²   ±       ××××°°°°°    "
"                 ±±     °      °  ² ²\       /  / ²   ±           ××××°°°° "
"±±±              °      °      °  ²×² \     /  /  ²   ±^              ×××× "
"          ±±     °      °         ² ²  \   /  /  /²   ×±                 ° "
"          °      °      °        ²²    /  /  / ²    ±^                ° "
"          °      °                ² ²       /  /  ²    ±°°°°°°°°°°°°°°°°°° "
"±±        °      °                ² ²   /  /  /   ²    ±                   "
"          °                       ²×²  /  /  /    ²    ±                   "
"          ° ±±±±±±                ²   /     /    ²   ±× °°°°°°°°°°°°°°°°° "
"          °      °                   /  /  /      ²   ±                  ° "
"±         °      °                  /  /  /       ²   ±  /±      ±± ±±±±±° "
"          °^±±±± °   ±             /  /     Û     ²   ±  ±Û±     ±R H r h° "
"                 °   °            /  /  /   Û     ²  ±×  \± \   ÛÛÛÛÛÛÛ  ° "
"                 °   °            ² /  /    Û     ²  ±   °   \     ²²²²² ° "
"±±±±      ±±±±±± °  ±°            ² ² /     Û     ²  ±   °           ±±±° "
"                                    ²   abcdÛ     ² ±×   °            °° ° "
"                    pP±±±±±±      ² ²  Ûe 2fÛ2      ±    °    \          ° "
"                                  ² ² ÛÛg  iÛÛ²²²²²±×    °     \         ° "
"                                  ² ²  Ûj 3kÛ3           °      \        ° "
"^^^^^^^^^^^^^^^^^^^^^^^^^^^^^^^^^ ²   ÛÛlmnoÛÛ²²²²²    ^^°  ^  \         "
