"     9±±± ±±±±  ±±±1   °\°°45°°1/°36                                 "
"   /±±   ±    ±±   ±   °°\°°°°/°°×Û                                  "
"   /±9              ±   °°\°°°°/°° Û                                  "
" /  ±              ±    °°\0°°/°°  Û    "
" /   ±             ±     °°°°/°°   Û A   ab   BC   cd   DE   ef   F   "
"    ±               ±      °°/°°    Û                                  "
"\  ±              ±      °°/°°°°    Û                                  "
" \   ±                ±    °°/°°\0°°   Û                                  "
"  \ ±            ± ±   °°/°°°°\°° Û^   ^   ^   ^   ^   ^   ^   ^   ^ "
"    ±            ±±±   °°/°°°°\°°×Û^ ^^ ^^ ^^ ^^ ^^ ^^^ ^^ ^ "
"  /±            ±   °/°°°°\°Û  ^   ^   ^   ^   ^   ^^^^^   ^ /"
"  /  ±     ±±      ±ÛÛÛ× °°°°°°Û      ²   ^   ^   ^   ^       (/ "
" /    ±   ± °±±±± 8±ÛÛ  °°°34°°°Û      ²    ^ ^ ^ ^ ^ ^g  G²   )  "
"       ±±±  °8°±±7ÛÛ  °\°°°°/°Û      ²              ²^ ^^²   (\ "
"\         °°  ÛÛÛ× °°\°°°°/°°×Û²   ² ² ²   ² i² ²×I ²    ²  () \"
"\          °°   ÛÛ  °°\°°°°/°° Û²   ²   ²   ²^^² ²×  ²    ²   (  "
" \       °°   ÛÛ   °°\2°°/°°  Û²² ²²² ²²² ²²²²² ²×  ²^^   ^  ) /"
"  \       °×°   ÛÛÛ×   °°°°/°°   Û                  ×           (/ "
"   \      °°   ÛÛ     °°/°°    Û  k   K    J    j ²²²²h  H²^ ()  "
"×   \      °°   ÛÛ     °°/°°°°    Û                     ²^^^^²^  (\ "
"     \   °°   ÛÛÛ×   °°/°°\2°°   Û                     ²       ) \"
"      \   °×°  ÛÛ   °°/°°°°\°° Û                        ²×²\  (  "
"       \  °°  ÛÛ  °°/°°°°\°°×Û                    ^²  ²×²  () /"
"        °°ÛÛÛ×  /°°°°\  Û                     ²²²²×²   (/ "
"×      °ÛÛ   /°°56°°\  Û7 ^ ^^^ ^ ^^^^ ^^  ^     ×²      "
