"       4        Û5 Û 3 Û  ××××××   Þ6Û       Ý                          "
"×²\             Û ÛÛ ÛÛ           ÞÛ        Ý                          "
"×² \    5        Û6/ \^/            Þ7Û        Ý                          "
"×²  \            Û/   ß         0   Þ/         Ý                          "
"×²   \          4Û                  Þ          Ý                          "
"×²             fpq\       /\       /Þ          Ý                          "
"×²    /         r  \     / \     / Þ         Ý                          "
"×²   /              \   /    \   / 7Þ A      a Ý                          "
"×²  /                \ /      \ /   Þ          Ý                          "
"×² /                 ±±  l   ± ±  Þ          Ý                          "
"×²                   ± ±      ± ±   Þ          Ý                          "
"×²\            ²²²²  ±±      ± ±  8Þ          Ý                          "
"×² \           ² × ² ± ±      ± ±   Þ          Ý                          "
"×²  \          ²    ²±±      ± ±   Þ          Ý                          "
"×²   \   FPQ   ²    ²± ±      ± ±   Þ         Ý                          "
"×²     G  R  ²²² 2  ²±±      ± ±   Þ b      B Ý                          "
"×²      g  ²²²    ^  ²± ±      ± ±   Þ          Ý                          "
"×²      ²²²     eo±±±±±±^^L   ± ±   Þ          Ý                          "
"×²   ²²²          ±       ^    ± ± J Þ          Ý                          "
"×²²²²           /1±DM   dm^²  k± ±i IÞ          Ý                          "
"×             _/   ^ ^^^^^^    ± ±HjhÞ          Ý                          "
"×          ^^/       ²8°       ± ±/ÛÛÛ^^^^^^^^  Ý                          "
"×       ^^^^/  ×     ² °       ± ±Û0            Ý                          "
"      ^^^^^/   2     ² °       ± ±Û  ÞCN      cnÝ                          "
"EO ^^^^^^^/3    °^  1²    K    ±^±\ÛÛÛ^^^^^^^^^^ß                          "
