"    ××××0°°             °°0              °°°°                             "
"           °°°       °°°      °°°      °°°                                 "
"  ×           °°° °°°            °°°°°°    °°°°°°°°°°                      "
"                ±±±                    °°°              °   °             "
"              ±±°°°±±         Û     °°°°    °°°°°°    °         °          "
"             ±°°°°°°°±           °°°     °°°                               "
"      ²²²²²²²²²²²²²²²²²²²²²²² °°°     °°°           °     ^       °        "
"     ²  °                   ²°    °°°                                     "
"  ×  ²\  °                  ²°   °                    ^^                "
" ^^^^² \ °      °            ² ° °                 °              °      "
"     ²   °       \           ² ° °                                         "
"×    ²  /°                   ² ° °\              /                       "
"     ² / °    °   \          ² ° ° \            /                          "
"     ²   °                   ² ° °  \          /   °               °       "
"     ²\  °         \         ² ° °   \  ±××±  /                          "
"^   ×² \ °  °                ² ° °    ±×    ×±                             "
"  ×  ²                       ² ° °    ×      ×      °             °        "
"     ²A°°^^^^^^^^^^^^^^^^^^^ ²a° °   ±        ±                     ^      "
"      ²²²²²²²²²²²²²²²²²²²²²²× °° °   ×      ×       °        °         "
"^ ^ °     ±±±       ±±±    ° ° °   ×      ×          °   °             "
"     °    ±±           ±±    ° °×°   ±        ±                  ^  ^      "
" ^    °  ±±             ±±  ° °   °   ×      ×                           "
"      °  ±±      ×      ±±  ° ²  ²   ±×    ×±              ×              "
"       ° ±               ± °  °^^^°  /  ±××±  \                          "
"^^^^^^^° ×               × °   °×°^^^^^^^^^^^^^^^^^^^^^^^^ ^^^^^^^ ^ ^^^^"
