"   6   7   8   5   4           3    АА     зззззззззззззззззз2       2А   "
"   А       А       А           Б    АА    Б1               з        А 0 "
"  / \     / \     / \          Б   / з \   Б                         А \ "
" /   \   /   \   /   \         Б  /     \  Б                           А   "
"       А       А               Б  А   А  Б                         А  /"
"      / \     / \              Б  А   А  Б                         АА 1 "
"     /   \   /   \             Б\  \   /  /Б    з                  А     "
"                               Б \  \ /  / з                       А      "
" 4   3   5   6   7   8         Б  \ АА /  Б                       А      "
"ААААААААААААААААААААААААА     Б    АзА    Б                      А      0"
"                         А     Б   /   \   Б                      А       "
"                         А    /Б  /     \  Б                    А        "
"                         А   / Б  А   А  Б                    А        "
"                            /  Б  А   А  БA          a          А       "
"                           /   Б\  \   /  /Б                   ллллл      А"
"зА\   /А\   /А\   /А\   /АлллллБ \  \ /  / Б                   л           "
" А ^^ А ^^ А ^^ А ^^ Ал    Б  \ АА /  Б                   л           "
" лллллллллллллллллллллллллл ллзБ    АзА    Б   ВВзВВзВВзВВзВ   л           "
" лb  g                   B  GлзБ   /   \   Б  В         В  ллл         "
" лc  h                   C  HлзБ  /     \  БВ               Вл           "
"злd  i              D  IлзБ  А   АБ БВ                 Вл           "
" лe  j                   E  JлзБ БА   АБ Б                   В           "
" лf  k               F  Kлз   Б\   /Б                      Вл          "
" лл ллллллллллллллллллллллллллз    Б\ /Б       /\ /\ /\ /\ /\  В           "
"    \/\/\/\/\/\/\/\/\/\/\/\/\лз ^   з з   ^   ^  ^  ^  ^  ^    з   ^^^^^^^^"
