" f××××××××××××××²  \         ××\       ±4    \             Û2Û0Û1Û"
"  ²              ²\ \      ××\     ±      \  g^^^^^^\G Û ÛÛ Û"
"  ²              ²× \ \        / °\  ^ ×±       \         \ Û Û Û Û"
" F²^^ ^^^ ^^^ ^^^²  \ \      /  ° \ ^   \      \        °°°°°°° °°Û Û Û Û"
" E²   /° /  °\   ²  ×\ \    /   °   ^    \       \      °      °Û Û Û Û"
"  ²  / °    ° \  ²    \ \/    °  / ^    \      \      °        °Û Û Û Û"
"  ² /  °\   °  \ ²     \ \/  ×  ° /   ^   ×\       \     °      °Û Û Û Û"
" e²    ° \  °    ²×      \ \     °     ^     \       \    °°°     °°\     /"
" d²    °  \ °    ²  ^ ^  \ \    5\     ^     \       \   °      °°\   /°"
"  ²^   °    °    ²       ± ±           ^      \      \  °        °°°\ /°°"
"  ² \  °    °   ^²     × ± ±    ×       ^^    ×\       \ °      ° °°3°° "
" D²  \ °    °  / ²       ± ±              ^^    \        °°°°  °°°° °°°  "
" C²    °   ^° /  ²  ×     ± ±               ^     \     /^°           /  "
"  ²    °  / °    ² ^   ^ ± ±               5^     \   / 4°           /   "
"  ²   ^° /  °    ²^      ± ±               × ^^^   ²²²   °         /    "
" c²  / °    °^   ²       ± ±                    ^ ××××   °°°       /    "
" b² /  °    ° \  ²  ^   ×± ± ^^^     ^^^     ^^^         °        /     "
"  ²    °    °  \ ²   ^   ^ /^°°°^^^^^°°°^   ^°°°^^ ^^°°°°       /      "
"  ²^   °    °    ²   ×  ^ /°°   °°°°°   °°°°°   °°°°°   °°      /       "
" B² \  °^   °   ^²     ^ /°                               °    /       /"
" A²  \ ° \  °  / ²    ^ /                                      /       / "
"  ²    °  \ ° /  ²   ^ /                                      /       /  "
"  ²    °    °    ²  ^ /        /\      /\      /\      /\    /       /   "
" a²°° ^°°° /°^^ °²× ^ /        /  \ ^^ /  \ ^^ /  \ ^^ /  \  /       /    "
" ² ° 0° ° 1° ° 2°3^          /    ^  ^    ^  ^    ^  ^    \        /     "
