"××××××××²                  \       0       /                    Û        "
"       ×1²                  \              /                 /²RÛ        "
"       × ²            E      \      a B      /                /×² Û    /±± "
"Ûpq    ××²      × ÛÛ  e  × × \               /               /××² Û  /±±/  "
"         ²     ±    ÛÛ×     \               /           U  /×× ²   /±/    "
"         ²   /±       ^^^^^ \               /             /××° ²   ±/    ×"
"         ²  / ±             \               /           u/××°  ²  /±      "
"         ² /  ± \         × \               /           ^××°   ²  ±/      "
"         ²    ±  \          \               /          ^××°    ²  ±       "
"         ²\    \            \               /      S  ^××°    ^² /±      ×"
"         ² \    \     F  ×   \               /        ^××°      ² ±        "
"         ²  \    \  \ f      \               /      s^××°       ² ±        "
"      PQ ²        \  \       \   A D c b   /       ^××°        ² ±        "
"      noÛ²   /     \         \             /   T  ^××°       ^ ² ±       ×"
"         ²  /       \     ×   \           /      ^ ×°      ^  ² ±        "
"         ² /         ^×       \           /    t^  ×°   ^      ² ±×   ×   "
"         ²       ×            \         /     ^   ×°        ^ ² ±×       "
"          \           G         \         / V  ^    ×°          ² ±×\  1  /"
"×NO        \    ^^    g      ×   \       /    /     ×° ^       ^² ±× \   / "
"            \     ^    ×        \  C d  /  v/      ×°     ^    ² ±×  \ /  "
"             \     ^             \     /   /       ×°          ² ±×  ° °  "
" ×            \     ^^   ×     × \     /  /        ×°       ^  ² ±×  ° °  "
"               \                  \   /  /    / \  ×°ÛÛ^ÛÛÛÛÛÛ ² ±×  / \  "
"^^  ^^  ^^  ^   \                 \   / /    /   \ ×°         ²±× /   \ "
" MmlLKkjJIihH         ^^^^^^^^^^^ 0\/      /^^^^^\×°wW       ²r±×   ^^  "
